00000000000000000000000000
01111111111110001111111110
01111111111110001111111110
01111111111110001111111110
01111111111111111111111110
00000001111111111111111110
01111101111111111111111110
01111101111111111111111110
01111101111111111111111110
01111101111111111111111110
01111111111111111100111110
01111111111111111100111110
01111111111111111100111110
00000001111111111100000000
00000001111111111111111110
01111111111111111111111110
01111111111110000111111110
01111111111111111100011110
01111100011111111100011110
01111100011111111111111110
01111100013111100011111110
01111100011111100011111110
01111100011111111111111110
01111100011111111111111110
01111100011111111111111110
00000000000000000000000000
