00000000000000000000000000
01111111111111111111111110
01111111111111111111111110
01111111111111111111111110
01111111111111111111111110
01111111111111111111111110
01111111111111111111111110
01111111111111111111111110
01111111111111111111111110
01111111111111111111111110
01111111111111111111111110
01111111111111111111111110
01111111111111111111111110
01111111111111111111111110
01111111111111111111111110
01111111111111111111111110
01111111111111111111111110
01111111111111111111111110
01111111111111111111111110
01111111111111111111111110
0111111111#111111111111110
01111111111111111111111110
01111111111111111111111110
01111111111111111111111110
01111111111111111111111110
00000000000000000000000000
