00000000
00011110
01111110
01100110
01101100
01111000
03111000
00000000