00000000000
01111111110
01111100110
01101111110
01111001110
01111111110
01111111110
01100111110
01111111110
03111111110
00000000000