00000000
01111110
01111110
01111110
01111110
01111110
03111110
00000000