000000000000000
011111111111110
011111111100110
011111111111110
011100011111110
000000011111110
011111011111110
0111110111#1110
011111011111110
011111111111110
011111111101110
011111111111110
011110111111110
000000011111110
000000000000000
